а=а
е=е
о=о
ө=ө
р=р
й=й
и=и
п=п
ы=ы
ң=ң
м=м
у=у
ү=ү
ым=ым
им=им
ум=ум
үм=үм
ың=ың
иң=иң
уң=уң
үң=үң
сы=сы
си=си
су=су
сү=сү
га=га
ге=ге
го=го
гө=гө
ка=ка
ке=ке
ко=ко
кө=кө
на=на
не=не
но=но
нө=нө
ны=ны
ни=ни
ну=ну
нү=нү
ды=ды
ди=ди
ду=ду
дү=дү
ти=ти
ту=ту
тү=тү
да=да
де=де
до=до
дө=дө
та=та
те=те
то=то
тө=тө
ма=м@@а
ме=м@@е
мо=м@@о
мө=м@@ө
ңа=ң@@а
ңе=ң@@е
ңо=ң@@о
ңө=ң@@ө
ын=ы@@н
ин=и@@н
ат=а@@т
ет=е@@т
от=о@@т
өт=ө@@т
йт=й@@т
ар=ар
ер=ер
ор=ор
өр=өр
ып=ып
ип=ип
уп=уп
үп=үп
ды=ды
ты=ты
чу=чу
чү=чү
ба=ба
бе=бе
бо=бо
бө=бө
са=са
гы=гы
ги=ги
гу=гу
гү=гү
кы=кы
ки=ки
ку=ку
ку=ку
оо=оо
уу=уу
өө=өө
үү=үү
лар=лар
лер=лер
лор=лор
лөр=лөр
дар=дар
дер=дер
дор=дор
дөр=дөр
тар=тар
тер=тер
тор=тор
төр=төр
ңыз=ңыз
ңиз=ңиз
ңуз=ңуз
ңүз=ңүз
ңар=ңар
ңер=ңер
ңор=ңор
ңөр=ңөр
нын=нын
нин=нин
нун=нун
нүн=нүн
дын=дын
дин=дин
дун=дун
дүн=дүн
тын=тын
тин=тин
тун=тун
түн=түн
нда=нда
нде=нде
ндо=ндо
ндө=ндө
дан=дан
ден=ден
дон=дон
дөн=дөн
тан=тан
тен=тен
тон=тон
төн=төн
нан=нан
нен=нен
нон=нон
нөн=нөн
мын=мын
мин=мин
мун=мун
мүн=мүн
сың=сың
сиң=сиң
суң=суң
сүң=сүң
сыз=сыз
сиз=сиз
суз=суз
сүз=сүз
быз=быз
биз=биз
буз=буз
бүз=бүз
мды=м@@ды
мда=м@@да
сын=сы@@н
мди=м@@ди
мде=м@@де
ыма=ым@@а
ңды=ң@@ды
ңда=ң@@да
ына=ы@@на
шат=ш@@а@@т
шет=ш@@е@@т
шөт=ш@@ө@@т
шар=ш@@ар
шер=ш@@ер
бас=бас
бес=бес
бос=бос
бөс=бөс
дым=ды@@м
дың=ды@@ң
дык=ды@@к
шты=ш@@ты
дим=ди@@м
диң=ди@@ң
дик=ди@@к
шти=ш@@ти
дүм=дү@@м
дүң=дү@@ң
дүк=дү@@к
штү=ш@@тү
шпа=ш@@па
шчу=ш@@чу
шчү=ш@@чү
ары=ар@@ы
гын=гын
гин=гин
гун=гун
гүн=гүн
кын=кын
кин=кин
кун=кун
күн=күн
сам=са@@м
сак=са@@к
йын=йын
йин=йин
йун=йун
йүн=йүн
алы=алы
ели=ели
гай=гай
гей=гей
мак=мак
мек=мек
мок=мок
мөк=мөк
май=май
мей=мей
мой=мой
мөй=мөй
ыңыз=ыңыз
иңиз=иңиз
уңуз=уңуз
үңүз=үңүз
ыбыз=ыбыз
ибиз=ибиз
убуз=убуз
үбүз=үбүз
ыңар=ыңар
иңер=иңер
уңар=уңар
үңөр=үңөр
ныкы=ныкы
ники=ники
нуку=нуку
нүкү=нүкү
дыкы=дыкы
дики=дики
дуку=дуку
дүкү=дүкү
тыкы=тыкы
тики=тики
туку=туку
түкү=түкү
лары=лар@@ы
лери=лер@@и
лору=лор@@у
лөрү=лөр@@ү
дары=дар@@ы
дери=дер@@и
дөрү=дөр@@ү
тары=тар@@ы
тери=тер@@и
тору=тор@@у
төрү=төр@@ү
мдан=м@@дан
мдин=м@@дин
мден=м@@ден
мсың=м@@сың
мсиң=м@@сиң
мсыз=м@@сыз
мсиз=м@@сиз
ымды=ым@@ды
ымда=ым@@да
ңнын=ң@@нын
ңнан=ң@@нан
ңмын=ң@@мын
ңбыз=ң@@быз
ңмин=ң@@мин
ңбиз=ң@@биз
сына=сы@@на
ынын=ы@@нын
ында=ы@@нда
ынан=ы@@нан
ымын=ы@@мын
ысың=ы@@сың
ысыз=ы@@сыз
ыбыз=ы@@быз
амын=а@@мын
асың=а@@сың
асыз=а@@сыз
абыз=а@@быз
ышат=ыш@@а@@т
есиң=е@@сиң
есиз=е@@сиз
ебиз=е@@биз
ишет=иш@@е@@т
ймын=й@@мын
йсың=й@@сың
йсыз=й@@сыз
йбыз=й@@быз
ймин=й@@мин
йсиң=й@@сиң
йсиз=й@@сиз
йбиз=й@@биз
өсүң=ө@@сүң
өсүз=ө@@сүз
өбүз=ө@@бүз
үшөт=үш@@ө@@т
байм=ба@@й@@м
байт=ба@@й@@т
бейм=бе@@й@@м
бейт=бе@@й@@т
бөйм=бө@@й@@м
бөйт=бө@@й@@т
ышар=ыш@@ар
ишер=иш@@ер
рмин=р@@мин
рсиң=р@@сиң
рсиз=р@@сиз
рбиз=р@@биз
шпес=ш@@пес
ганы=ганы
гени=гени
гону=гону
гөнү=гөнү
каны=каны
кени=кени
кону=кону
көнү=көнү
ууда=ууда
оодо=оодо
өөдө=өөдө
үүдө=үүдө
ышты=ыш@@ты
ишти=иш@@ти
үштү=үш@@тү
бады=ба@@ды
бөдү=бө@@дү
шкен=ш@@кен
ышпа=ыш@@па
ышчу=ыш@@чу
ушчу=уш@@чу
ишчү=иш@@чү
үшчү=үш@@чү
гөнү=гөн@@ү
арым=ар@@ым
арың=ар@@ың
арга=ар@@га
арды=ар@@ды
арда=ар@@да
гыча=гыча
гиче=гиче
гуча=гуча
гүчө=гүчө
кыча=кыча
киче=киче
куча=куча
күчө=күчө
ндым=н@@ды@@м
гыла=гыла
айын=айын
ейин=ейин
ойун=ойун
өйүн=өйүн
сыңар=сыңар
сиңер=сиңер
суңар=суңар
сүңөр=сүңөр
ларым=лар@@ым
ларың=лар@@ың
ларга=лар@@га
ларды=лар@@ды
ларда=лар@@да
ларын=лар@@ы@@н
лерим=лер@@им
лериң=лер@@иң
лерге=лер@@ге
лерди=лер@@ди
лерде=лер@@де
лорум=лор@@ум
лоруң=лор@@уң
лөрүм=лөр@@үм
лөрүң=лөр@@үң
дарым=дар@@ым
дарың=дар@@ың
дарга=дар@@га
дарды=дар@@ды
дарда=дар@@да
дарын=дар@@ы@@н
дерим=дер@@им
дериң=дер@@иң
дерге=дер@@ге
дерди=дер@@ди
дерде=дер@@де
дерин=дер@@и@@н
дорум=дор@@ум
доруң=дор@@уң
дөрүм=дөр@@үм
дөрүң=дөр@@үң
тарым=тар@@ым
тарың=тар@@ың
тарга=тар@@га
тарды=тар@@ды
тарда=тар@@да
тарын=тар@@ы@@н
терим=тер@@им
териң=тер@@иң
терди=тер@@ди
торум=тор@@ум
торуң=тор@@уң
төрүм=төр@@үм
төрүң=төр@@үң
ымдын=ым@@дын
ымдан=ым@@дан
ымсың=ым@@сың
ымсыз=ым@@сыз
ңдесиз=ң@@де@@сиз
ңдебиз=ң@@де@@биз
сынын=сы@@нын
сында=сы@@нда
сынан=сы@@нан
сымын=сы@@мын
сысың=сы@@сың
сысыз=сы@@сыз
сыбыз=сы@@быз
бызга=быз@@га
бызды=быз@@ды
бызда=быз@@да
бизге=биз@@ге
бизди=биз@@ди
бизде=биз@@де
ңарга=ңар@@га
ңарды=ңар@@ды
ңарда=ңар@@да
ңерге=ңер@@ге
ңерди=ңер@@ди
ңерде=ңер@@де
армын=ар@@мын
арсың=ар@@сың
арсыз=ар@@сыз
арбыз=ар@@быз
ермин=ер@@мин
ерсиң=ер@@сиң
ерсиз=ер@@сиз
ербиз=ер@@биз
ышпас=ыш@@пас
ишпес=иш@@пес
дыңыз=ды@@ңыз
дыңар=ды@@ңар
диңиз=ди@@ңиз
диңер=ди@@ңер
дүңөр=дү@@ңөр
бадым=ба@@ды@@м
бадың=ба@@ды@@ң
бадык=ба@@ды@@к
бөдүм=бө@@дү@@м
бөдүң=бө@@дү@@ң
бөдүк=бө@@дү@@к
шпөдү=ш@@пө@@дү
ышкан=ыш@@кан
ишкен=иш@@кен
баган=ба@@ган
ыпмын=ып@@мын
ыпсың=ып@@сың
ыпсыз=ып@@сыз
ыпсыз=ып@@сыз
ыптыр=ыптыр
ыпбыз=ып@@быз
чумун=чу@@мун
чусуң=чу@@суң
чусуз=чу@@суз
чубуз=чу@@буз
чүмүн=чү@@мүн
чүсүң=чү@@сүң
чүсүз=чү@@сүз
чүбүз=чү@@бүз
чулар=чу@@лар
чүлөр=чү@@лөр
ганым=ган@@ым
ганың=ган@@ың
гөнүм=гөн@@үм
гөнүң=гөн@@үң
уучум=уучу@@м
уучуң=уучу@@ң
үүчүм=үүчү@@м
үүчүң=үүчү@@ң
ганга=ган@@га
ганды=ган@@ды
ганда=ган@@да
генге=ген@@ге
генди=ген@@ди
генде=ген@@де
ардын=ар@@дын
ардан=ар@@дан
армын=ар@@мын
арсың=ар@@сың
арсыз=ар@@сыз
арбыз=ар@@быз
ганча=ганча
генче=генче
гончо=гончо
гөнчө=гөнчө
канча=канча
кенче=кенче
кончо=кончо
көнчө=көнчө
ындым=ын@@ды@@м
ылдык=ыл@@ды@@к
ыштым=ыш@@ты@@м
ыттым=ыт@@ты@@м
багын=ба@@гын
саңыз=са@@ңыз
саңар=са@@ңар
басам=ба@@са@@м
макчы=макчы
мекчи=мекчи
мокчу=мокчу
мөкчү=мөкчү
гызды=гыз@@ды
ңыздар=ңыздар
ңиздер=ңиздер
ңуздар=ңуздар
ңүздөр=ңүздөр
сыздар=сыздар
сиздер=сиздер
суздар=суздар
сүздөр=сүздөр
лардын=лар@@дын
лардан=лар@@дан
ларбыз=лар@@быз
ларына=лар@@ы@@на
лердин=лер@@дин
лерден=лер@@ден
лербиз=лер@@биз
лерине=лер@@и@@не
дардын=дар@@дын
дардан=дар@@дан
дарбыз=дар@@быз
дарыма=дар@@ым@@а
дарына=дар@@ы@@на
дердин=дер@@дин
дерден=дер@@ден
дербиз=дер@@биз
дериме=дер@@им@@е
дериңе=дер@@иң@@е
дерине=дер@@и@@не
тардын=тар@@дын
тардан=тар@@дан
тарбыз=тар@@быз
тарыма=тар@@ым@@а
тарыңа=тар@@ың@@а
тарына=тар@@ы@@на
мсыңар=м@@сыңар
мсиңер=м@@сиңер
мдамын=м@@да@@мын
мдасың=м@@да@@сың
мдасыз=м@@да@@сыз
мдабыз=м@@да@@быз
мдемин=м@@де@@мин
мдесиң=м@@де@@сиң
мдесиз=м@@де@@сиз
мдебиз=м@@де@@биз
ңдамын=ң@@да@@мын
ңдасың=ң@@да@@сың
ңдасыз=ң@@да@@сыз
ңдабыз=ң@@да@@быз
ңдемин=ң@@де@@мин
ңдесиң=ң@@де@@сиң
ңдесиз=ң@@де@@сиз
ңдебиз=ң@@де@@биз
ысыңар=ы@@сыңар
быздын=быз@@дын
быздан=быз@@дан
биздин=биз@@дин
бизден=биз@@ден
ыбызга=ыбыз@@га
ыбызды=ыбыз@@ды
ыбызда=ыбыз@@да
ибизге=ибиз@@ге
ибизди=ибиз@@ди
ибизде=ибиз@@де
ңардан=ңар@@дан
ңердин=ңер@@дин
ңерден=ңер@@ден
иңерге=иңер@@ге
иңерди=иңер@@ди
иңерде=иңер@@де
асыңар=а@@сыңар
есиңер=е@@сиңер
йсыңар=й@@сыңар
йсиңер=й@@сиңер
өсүңөр=ө@@сүңөр
байсың=ба@@й@@сың
байсыз=ба@@й@@сыз
бейсиң=бе@@й@@сиң
бейсиз=бе@@й@@сиз
бейбиз=бе@@й@@биз
бөйсүң=бө@@й@@сүң
бөйсүз=бө@@й@@сүз
бөйбүз=бө@@й@@бүз
басмын=бас@@мын
бассың=бас@@сың
бассыз=бас@@сыз
баспыз=бас@@пыз
бесмин=бес@@мин
бессиң=бес@@сиң
бессиз=бес@@сиз
беспиз=бес@@пиз
үшпөдү=үш@@пө@@дү
ганмын=ган@@мын
гансың=ган@@сың
гансыз=ган@@сыз
ганбыз=ган@@быз
генмин=ген@@мин
генсиң=ген@@сиң
генсиз=ген@@сиз
шыптыр=ш@@ыптыр
бапмын=ба@@п@@мын
бапсың=ба@@п@@сың
бапсыз=ба@@п@@сыз
баптыр=ба@@птыр
бапбыз=ба@@п@@быз
гандар=ган@@дар
гендер=ген@@дер
гондор=гон@@дор
гөндөр=гөн@@дөр
кандар=кан@@дар
кендер=кен@@дер
кондор=кон@@дор
көндөр=көн@@дөр
арыңыз=ар@@ыңыз
арыбыз=ар@@ыбыз
уучусу=уучу@@су
үүчүсү=үүчү@@сү
гандын=ган@@дын
гандан=ган@@дан
гендин=ген@@дин
генден=ген@@ден
уучуго=уучу@@го
уучуну=уучу@@ну
уучудо=уучу@@до
үүчүгө=үүчү@@гө
үүчүнү=үүчү@@нү
үүчүдө=үүчү@@дө
ганмын=ган@@мын
гансың=ган@@сың
гансыз=ган@@сыз
ганбыз=ган@@быз
канмын=кан@@мын
кансың=кан@@сың
кансыз=кан@@сыз
канбыз=кан@@быз
уучума=уучу@@м@@а
моюнча=моюнча
дырдым=дыр@@ды@@м
гыздык=гыз@@ды@@к
лериме=лер@@им@@е
ыңыздар=ыңыздар
иңиздер=иңиздер
уңуздар=уңуздар
үңүздөр=үңүздөр
ларыңыз=лар@@ыңыз
ларыбыз=лар@@ыбыз
ларымга=лар@@ым@@га
ларымды=лар@@ым@@ды
ларымда=лар@@ым@@да
ларыңга=лар@@ың@@га
ларыңды=лар@@ың@@ды
ларыңда=лар@@ың@@да
ларынын=лар@@ы@@нын
ларында=лар@@ы@@нда
ларынан=лар@@ы@@нан
ларымын=лар@@ы@@мын
ларыбыз=лар@@ы@@быз
ларысың=лар@@ы@@сың
ларысыз=лар@@ы@@сыз
лериңиз=лер@@иңиз
лерибиз=лер@@ибиз
леримди=лер@@им@@ди
леримде=лер@@им@@де
лериңди=лер@@иң@@ди
лериңде=лер@@иң@@де
лериңден=лер@@иң@@ден
леринин=лер@@и@@нин
леринде=лер@@и@@нде
леринен=лер@@и@@нен
леримин=лер@@и@@мин
лерибиз=лер@@и@@биз
лерисиң=лер@@и@@сиң
лерисиз=лер@@и@@сиз
лоруңуз=лор@@уңуз
лорубуз=лор@@убуз
лөрүңүз=лөр@@үңүз
лөрүбүз=лөр@@үбүз
дарыңыз=дар@@ыңыз
дарыбыз=дар@@ыбыз
дарымды=дар@@ым@@ды
дарымда=дар@@ым@@да
дарыңды=дар@@ың@@ды
дарыңда=дар@@ың@@да
дарынын=дар@@ы@@нын
дарында=дар@@ы@@нда
дарынан=дар@@ы@@нан
дериңиз=дер@@иңиз
дерибиз=дер@@ибиз
деримди=дер@@им@@ди
деримде=дер@@им@@де
дериңди=дер@@иң@@ди
дериңде=дер@@иң@@де
деринен=дер@@и@@нен
деринде=дер@@и@@нде
деримин=дер@@и@@мин
доруңуз=дор@@уңуз
дорубуз=дор@@убуз
дөрүңүз=дөр@@үңүз
дөрүбүз=дөр@@үбүз
тарыңыз=тар@@ыңыз
тарыбыз=тар@@ыбыз
тарымды=тар@@ым@@ды
тарымда=тар@@ым@@да
тарыңды=тар@@ың@@ды
тарыңда=тар@@ың@@да
тарында=тар@@ы@@нда
тарынан=тар@@ы@@нан
териңиз=тер@@иңиз
терибиз=тер@@ибиз
торуңуз=тор@@уңуз
торубуз=тор@@убуз
төрүңүз=төр@@үңүз
төрүбүз=төр@@үбүз
мсыздар=м@@сыздар
мсиздер=м@@сиздер
мданмын=м@@дан@@мын
мдансың=м@@дан@@сың
мдансыз=м@@дан@@сыз
мданбыз=м@@дан@@быз
мденмин=м@@ден@@мин
мденсиң=м@@ден@@сиң
мденсиз=м@@ден@@сиз
мденбиз=м@@ден@@биз
ымсыңар=ым@@сыңар
ымдамын=ым@@да@@мын
ымдасың=ым@@да@@сың
ымдасыз=ым@@да@@сыз
ымдабыз=ым@@да@@быз
ңданмын=ң@@дан@@мын
ңдансың=ң@@дан@@сың
ңдансыз=ң@@дан@@сыз
ңданбыз=ң@@дан@@быз
сысыңар=сы@@сыңар
ысыздар=ы@@сыздар
ындамын=ын@@да@@мын
ындасың=ын@@да@@сың
ындасыз=ын@@да@@сыз
ындабыз=ын@@да@@быз
ынанмын=ы@@нан@@мын
ынансың=ы@@нан@@сың
ынансыз=ы@@нан@@сыз
ынанбыз=ы@@нан@@быз
ыбыздан=ыбыз@@дан
ибиздин=ибиз@@дин
ибизден=ибиз@@ден
иңердин=иңер@@дин
иңерден=иңер@@ден
асыздар=а@@сыздар
есиздер=е@@сиздер
йсыздар=й@@сыздар
йсиздер=й@@сиздер
өсүздөр=ө@@сүздөр
арсыңар=ар@@сыңар
ерсиңер=ер@@сиңер
рсиздер=р@@сиздер
бадыңыз=ба@@ды@@ңыз
бадыңар=ба@@ды@@ңар
бөдүңөр=бө@@дү@@ңөр
ыпсыңар=ып@@сыңар
шпаптыр=ш@@па@@птыр
чусуңар=чу@@суңар
чүсүңөр=чү@@сүңөр
оочулар=оочу@@лар
уучулар=уучу@@лар
үүчүлөр=үүчү@@лөр
өөчүлөр=өөчү@@лөр
ганыңыз=ган@@ыңыз
ганыбыз=ган@@ыбыз
гөнүңүз=гөн@@үңүз
гөнүбүз=гөн@@үбүз
арыңыз=ар@@ыңыз
арыбыз=ар@@ыбыз
уучуңуз=уучу@@ңуз
үүчүңүз=үүчү@@ңүз
үүчүбүз=үүчү@@бүз
уучунун=уучу@@нун
уучудон=уучу@@дон
үүчүнүн=үүчү@@нүн
үүчүдөн=үүчү@@дөн
ганымда=ган@@ым@@да
канымды=кан@@ым@@ды
канымда=кан@@ым@@да
уучумду=уучу@@м@@ду
майынча=майынча
мейинче=мейинче
мөйүнчө=мөйүнчө
ылдыңыз=ыл@@ды@@ңыз
ыштыңыз=ыш@@ты@@ңыз
ларымдын=лар@@ым@@дын
ларымдан=лар@@ым@@дан
ларыңнын=лар@@ың@@нын
ларыңнан=лар@@ың@@нан
ларымсың=лар@@ым@@сың
ларымсыз=лар@@ым@@сыз
ларыңмын=лар@@ың@@мын
ларыңбыз=лар@@ың@@быз
лардамын=лар@@да@@мын
лардасың=лар@@да@@сың
лардасыз=лар@@да@@сыз
лардабыз=лар@@да@@быз
лерсиңер=лер@@сиңер
леримдин=лер@@им@@дин
леримден=лер@@им@@ден
лериңнин=лер@@иң@@нин
лериңнен=лер@@иң@@нен
лериңбиз=лер@@иң@@биз
лердемин=лер@@де@@мин
лердесиң=лер@@де@@сиң
лердесиз=лер@@де@@сиз
лердебиз=лер@@де@@биз
дарсыңар=дар@@сыңар
дарымдын=дар@@ым@@дын
дарымнан=дар@@ым@@нан
дарыңнын=дар@@ың@@нын
дарыңнан=дар@@ың@@нан
дарыңмын=дар@@ың@@мын
дарыңбыз=дар@@ың@@быз
дардамын=дар@@да@@мын
дардасың=дар@@да@@сың
дардасыз=дар@@да@@сыз
дардабыз=дар@@да@@быз
дерсиңер=дер@@сиңер
деримдин=дер@@им@@дин
деримден=дер@@им@@ден
дериңнин=дер@@иң@@нин
дериңнен=дер@@иң@@нен
дериңмин=дер@@иң@@мин
дериңбиз=дер@@иң@@биз
дердемин=дер@@де@@мин
дердесиң=дер@@де@@сиң
дердесиз=дер@@де@@сиз
дердебиз=дер@@де@@биз
тарсыңар=тар@@сыңар
тарымдын=тар@@ым@@дын
тарымдан=тар@@ым@@дан
тарыңнын=тар@@ың@@нын
тарыңнан=тар@@ың@@нан
тарыңмын=тар@@ың@@мын
тарыңбыз=тар@@ың@@быз
тардамын=тар@@да@@мын
тардасың=тар@@да@@сың
тардасыз=тар@@да@@сыз
тардабыз=тар@@да@@быз
мдасыңар=м@@да@@сыңар
мдесиңер=м@@де@@сиңер
ымсыздар=ым@@сыздар
ымданмын=ым@@дан@@мын
ымдансың=ым@@дан@@сың
ымдансыз=ым@@дан@@сыз
ымданбыз=ым@@дан@@быз
сысыздар=сы@@сыздар
сындамын=сы@@н@@да@@мын
сындасың=сы@@н@@да@@сың
сындасыз=сы@@н@@да@@сыз
сындабыз=сы@@н@@да@@быз
сынанмын=сы@@нан@@мын
сынансың=сы@@нан@@сың
сынансыз=сы@@нан@@сыз
сынанбыз=сы@@нан@@быз
ңыздарга=ңыздар@@га
ңиздерге=ңиздер@@ге
байсыңар=ба@@й@@сыңар
бейсиңер=бе@@й@@сиңер
бөйсүңөр=бө@@й@@сүңөр
арсыздар=ар@@сыздар
ерсиздер=ер@@сиздер
бассыңар=бас@@сыңар
бессиңер=бес@@сиңер
дыңыздар=ды@@ңыздар
диңиздер=ди@@ңиздер
дүңүздөр=дү@@ңүздөр
гансыңар=ган@@сыңар
баганмын=ба@@ган@@мын
багансың=ба@@ган@@сың
багансыз=ба@@ган@@сыз
баганбыз=ба@@ган@@быз
ыпсыздар=ып@@сыздар
бапсыңар=ба@@п@@сыңар
ышпаптыр=ыш@@па@@птыр
чусуздар=чу@@суздар
чүсүздөр=чү@@сүздөр
гансыңар=ган@@сыңар
арсыздар=ар@@сыздар
гандарым=ган@@дар@@ым
гандарга=ган@@дар@@га
гандарды=ган@@дар@@ды
гандарда=ган@@дар@@да
кандарга=кан@@дар@@га
кандарды=кан@@дар@@ды
кандарда=кан@@дар@@да
ганымдан=ган@@ым@@дан
канымдын=кан@@ым@@дын
уучумдун=уучу@@м@@дун
баңыздар=ба@@ңыздар
саңыздар=са@@ңыздар
байсыздар=ба@@й@@сыздар
бейсиздер=бе@@й@@сиздер
бөйсүздөр=бө@@й@@сүздөр
бассыздар=бас@@сыздар
бессиздер=бес@@сиздер
гансыздар=ган@@сыздар
генсиздер=ген@@сиздер
бапсыздар=ба@@п@@сыздар
гансыздар=ган@@сыздар
кансыздар=кан@@сыздар
уучуларым=уучу@@лар@@ым
гандардын=ган@@дар@@дын
гандардан=ган@@дар@@дан
кандардын=кан@@дар@@дын
кандардан=кан@@дар@@дан
уучуларго=уучу@@лар@@го
уучуларду=уучу@@лар@@ду
уучулардо=уучу@@лар@@до
гандарбыз=ган@@дар@@быз
ндыңыздар=н@@ды@@ңыздар
ңиздердин=ңиздер@@дин
ыңыздарга=ыңыздар@@га
ыңыздарды=ыңыздар@@ды
ыңыздарда=ыңыздар@@да
ңыздардан=ңыздар@@дан
ынансыңар=ы@@нан@@сыңар
ындасыңар=ын@@да@@сыңар
ңнансыңар=ң@@нан@@сыңар
ңдесиздер=ң@@де@@сиздер
ңдасыздар=ң@@да@@сыздар
ымдасыңар=ым@@да@@сыңар
мденсиңер=м@@ден@@сиңер
мдансыңар=м@@дан@@сыңар
мдесиздер=м@@де@@сиздер
мдасыздар=м@@да@@сыздар
тарданмын=тар@@дан@@мын
тардансың=тар@@дан@@сың
тардансыз=тар@@дан@@сыз
тарданбыз=тар@@дан@@быз
тарсыздар=тар@@сыздар
дерденмин=дер@@ден@@мин
дерденсиң=дер@@ден@@сиң
дерденсиз=дер@@ден@@сиз
дерденбиз=дер@@ден@@биз
дерисиңер=дер@@и@@сиңер
дерсиздер=дер@@сиздер
дарданмын=дар@@дан@@мын
дардансың=дар@@дан@@сың
дардансыз=дар@@дан@@сыз
дарданбыз=дар@@дан@@быз
дарыңызга=дар@@ыңыз@@га
дарыңызды=дар@@ыңыз@@ды
дарыңызда=дар@@ыңыз@@да
лерденмин=лер@@ден@@мин
лерденсиң=лер@@ден@@сиң
лерденсиз=лер@@ден@@сиз
лерденбиз=лер@@ден@@биз
лерисиңер=лер@@и@@сиңер
лериңизде=лер@@иңиз@@де
лериңизге=лер@@иңиз@@ге
лериңизди=лер@@иңиз@@ди
лерсиздер=лер@@сиздер
ларданмын=лар@@дан@@мын
лардансың=лар@@дан@@сың
лардансыз=лар@@дан@@сыз
ларданбыз=лар@@дан@@быз
ларысыңар=лар@@ы@@сыңар
ларыңызга=лар@@ыңыз@@га
ларыңызды=лар@@ыңыз@@ды
ларыңызда=лар@@ыңыз@@да
ларсыздар=лар@@сыздар
ларыңыздын=лар@@ыңыз@@дын
ларыңыздан=лар@@ыңыз@@дан
ларымсыңар=лар@@ым@@сыңар
ларыңызмын=лар@@ыңыз@@мын
ларыңызбыз=лар@@ыңыз@@быз
ларысыздар=лар@@ы@@сыздар
лардасыңар=лар@@да@@сыңар
ларымдамын=лар@@ым@@да@@мын
ларымдасың=лар@@ым@@да@@сың
ларымдасыз=лар@@ым@@да@@сыз
ларымдабыз=лар@@ым@@да@@быз
ларыңдамын=лар@@ың@@да@@мын
ларыңдасың=лар@@ың@@да@@сың
ларыңдасыз=лар@@ың@@да@@сыз
ларыңдабыз=лар@@ың@@да@@быз
ларындамын=лар@@ы@@нда@@мын
ларындасың=лар@@ы@@нда@@сың
ларындасыз=лар@@ы@@нда@@сыз
ларындабыз=лар@@ы@@нда@@быз
лериңиздин=лер@@иңиз@@дин
лериңизден=лер@@иңиз@@ден
леримсиңер=лер@@им@@сиңер
лериңизбиз=лер@@иңиз@@биз
лерисиздер=лер@@и@@сиздер
лердесиңер=лер@@де@@сиңер
леримдемин=лер@@им@@де@@мин
леримдесиң=лер@@им@@де@@сиң
леримдесиз=лер@@им@@де@@сиз
леримдебиз=лер@@им@@де@@биз
лериңдемин=лер@@иң@@де@@мин
лериңдесиң=лер@@иң@@де@@сиң
лериңдесиз=лер@@иң@@де@@сиз
лериңдебиз=лер@@иң@@де@@биз
лериндемин=лер@@и@@нде@@мин
лериндесиң=лер@@и@@нде@@сиң
лериндесиз=лер@@и@@нде@@сиз
лериндебиз=лер@@и@@нде@@биз
дарыңыздан=дар@@ыңыз@@дан
дарыңыздан=дар@@ыңыз@@дан
дарымсыңар=дар@@ым@@сыңар
дарыңызмын=дар@@ыңыз@@мын
дарыңызбыз=дар@@ыңыз@@быз
дарысыздар=дар@@ы@@сыздар
дардасыңар=дар@@да@@сыңар
дарымдамын=дар@@ым@@да@@мын
дарымдасың=дар@@ым@@да@@сың
дарымдасыз=дар@@ым@@да@@сыз
дарымдабыз=дар@@ым@@да@@быз
дарыңдамын=дар@@ың@@да@@мын
дарыңдасың=дар@@ың@@да@@сың
дарыңдасыз=дар@@ың@@да@@сыз
дарыңдабыз=дар@@ың@@да@@быз
дарындамын=дар@@ы@@нда@@мын
дарындасың=дар@@ы@@нда@@сың
дарындасыз=дар@@ы@@нда@@сыз
дарындабыз=дар@@ы@@нда@@быз
деримсиңер=дер@@им@@сиңер
дериңизбиз=дер@@иңиз@@биз
дерисиздер=дер@@и@@сиздер
дердесиңер=дер@@де@@сиңер
деримдемин=дер@@им@@де@@мин
деримдесин=дер@@им@@де@@син
деримдесиз=дер@@им@@де@@сиз
деримдебиз=дер@@им@@де@@биз
тарымсыңар=тар@@ым@@сыңар
тарыңызбыз=тар@@ыңыз@@быз
тарысыздар=тар@@ы@@сыздар
тардасыңар=тар@@да@@сыңар
тарымдамын=тар@@ым@@да@@мын
тарымдасың=тар@@ым@@да@@сың
тарымдасыз=тар@@ым@@да@@сыз
тарымдабыз=тар@@ым@@да@@быз
тарыңдамын=тар@@ың@@да@@мын
тарыңдасың=тар@@ың@@да@@сың
тарыңдабыз=тар@@ың@@да@@быз
тарындамын=тар@@ы@@нда@@мын
тарындасың=тар@@ы@@нда@@сың
тарындабыз=тар@@ы@@нда@@быз
тарынанмын=тар@@ы@@нан@@мын
тарынансың=тар@@ы@@нан@@сың
тарынансыз=тар@@ы@@нан@@сыз
тарынанбыз=тар@@ы@@нан@@быз
мдансыздар=м@@дан@@сыздар
мденсиздер=м@@ден@@сиздер
ымдасыздар=ым@@да@@сыздар
ымдансыңар=ым@@дан@@сыңар
ңнансыздар=ң@@нан@@сыздар
сындасыңар=сы@@н@@да@@сыңар
ындасыздар=ы@@нда@@сыздар
ынансыздар=ы@@нан@@сыздар
ыңыздардын=ыңыз@@дар@@дын
ыңыздардан=ыңыз@@дар@@дан
бадыңыздар=ба@@ды@@ңыздар
бадыңыздар=ба@@ды@@ңыздар
багансыңар=ба@@ган@@сыңар
гандарыбыз=ган@@дар@@ыбыз
гандарыңыз=ган@@дар@@ыңыз
кандарыбыз=кан@@дар@@ыбыз
ындыңыздар=ын@@ды@@ңыздар
басаңыздар=ба@@са@@ңыздар
кондорумдун=кон@@дор@@ум@@дун
кандарымдын=кан@@дар@@ым@@дын
гандарымдын=ган@@дар@@ым@@дын
гандарсыңар=ган@@дар@@сыңар
уучуларыбыз=уучу@@лар@@ыбыз
багансыздар=ба@@ган@@сыздар
сынансыздар=сы@@нан@@сыздар
сындасыздар=сы@@нда@@сыздар
ымдансыздар=ым@@дан@@сыздар
тарыңнанмын=тар@@ың@@нан@@мын
тарыңнансың=тар@@ың@@нан@@сың
тарыңнанбыз=тар@@ың@@нан@@быз
тарымдансың=тар@@ым@@дан@@сың
тарымдансыз=тар@@ым@@дан@@сыз
тарымданбыз=тар@@ым@@дан@@быз
тардасыздар=тар@@да@@сыздар
тарымсыздар=тар@@ым@@сыздар
деримденмин=дер@@им@@ден@@мин
деримденсиң=дер@@им@@ден@@сиң
деримденсиз=дер@@им@@ден@@сиз
деримденбиз=дер@@им@@ден@@биз
деримсиздер=дер@@им@@сиздер
дарыңнанмын=дар@@ың@@нан@@мын
дарыңнансың=дар@@ың@@нан@@сың
дарыңнансыз=дар@@ың@@нан@@сыз
дарыңнанбыз=дар@@ың@@нан@@быз
дарымданмын=дар@@ым@@дан@@мын
дарымдансың=дар@@ым@@дан@@сың
дарымдансыз=дар@@ым@@дан@@сыз
дарымданбыз=дар@@ым@@дан@@быз
дардансыңар=дар@@дан@@сыңар
дардасыздар=дар@@да@@сыздар
дарымсыздар=дар@@ым@@сыздар
лерденсиңер=лер@@ден@@сиңер
лердесиздер=лер@@де@@сиздер
леримсиздер=лер@@им@@сиздер
ларыңнанмын=лар@@ың@@нан@@мын
ларыңнансың=лар@@ың@@нан@@сың
ларыңнансыз=лар@@ың@@нан@@сыз
ларыңнанбыз=лар@@ың@@нан@@быз
ларымданмын=лар@@ым@@дан@@мын
ларымдансың=лар@@ым@@дан@@сың
ларымдансыз=лар@@ым@@дан@@сыз
ларымданбыз=лар@@ым@@дан@@быз
лардансыңар=лар@@дан@@сыңар
лардасыздар=лар@@да@@сыздар
ларымсыздар=лар@@ым@@сыздар
лардансыздар=лар@@дан@@сыздар
ларымдасыңар=лар@@ым@@да@@сыңар
ларыңдасыңар=лар@@ың@@да@@сыңар
ларындасыңар=лар@@ы@@нда@@сыңар
лерденсиздер=лер@@ден@@сиздер
леримдесиңер=лер@@им@@де@@сиңер
лериңдесиңер=лер@@иң@@де@@сиңер
лериңиздемин=лер@@иңиз@@де@@мин
лериңиздесиз=лер@@иңиз@@де@@сиз
лериндесиңер=лер@@и@@нде@@сиңер
дардансыздар=дар@@дан@@сыздар
дарымдасыңар=дар@@ым@@да@@сыңар
дарыңдасыңар=дар@@ың@@да@@сыңар
дарындасыңар=дар@@ы@@нда@@сыңар
дерденсиздер=дер@@ден@@сиздер
деримдесиңер=дер@@им@@де@@сиңер
тардансыздар=тар@@дан@@сыздар
тарымдасыңар=тар@@ым@@да@@сыңар
тарыңдасыңар=тар@@ың@@да@@сыңар
гандарсыздар=ган@@дар@@сыздар
уучуларымдын=уучу@@лар@@ым@@дын
гандарыңыздан=ган@@дар@@ыңыз@@дан
кендериңизден=кен@@дер@@иңиз@@ден
гондоруңуздон=гон@@дор@@уңуз@@дон
гөндөрүңүздөн=гөн@@дөр@@үңүз@@дөн
гендериңизден=ген@@дер@@иңиз@@ден
көндөрүңүздөн=көн@@дөр@@үңүз@@дөн
ларымдасыздар=лар@@ым@@да@@сыздар
ларымдансыңар=лар@@ым@@дан@@сыңар
ларыңнансыңар=лар@@ың@@нан@@сыңар
ларындасыздар=лар@@ы@@нда@@сыздар
лериңдесиздер=лер@@иң@@де@@сиздер
лериндесиздер=лер@@и@@н@@де@@сиздер
дарымдасыздар=дар@@ым@@да@@сыздар
дарымдансыңар=дар@@ым@@дан@@сыңар
дарыңдасыздар=дар@@ың@@да@@сыздар
деримдесиздер=дер@@им@@де@@сиздер
деримденсиңер=дер@@им@@ден@@сиңер
тарымдасыздар=тар@@ым@@да@@сыздар
тарыңдасыздар=тар@@ың@@да@@сыздар
тарындасыздар=тар@@ы@@нда@@сыздар
тарымдансыңар=тар@@ым@@дан@@сыңар
тарыңнансыңар=тар@@ың@@нан@@сыңар
ларымдансыздар=лар@@ым@@дан@@сыздар
ларыңнансыздар=лар@@ың@@нан@@сыздар
дарымдансыздар=дар@@ым@@дан@@сыздар
дарыңнансыздар=дар@@ың@@нан@@сыздар
деримденсиздер=дер@@им@@ден@@сиздер
тарымдансыздар=тар@@ым@@дан@@сыздар